Taken by Wisest on August 31, 2021 to prevent any new regions with this name from being founded.

Member guide (from the previous region):
-Renland-: Renland
Anningtova: Ethan
Anovi: Soda
ARABIAN SMC: ???
Auvia: Notforc
Athayop: Hellocoders
Ayrodan: NJ
Bleinland: Voj
Dugong Island: Lucas
Federal Tristia: Deet
Federate Nesia: France
Geskyia: Skyminer
Grandist Remesia: Rem
Greater Transamur: Ontario
Great Shibe Poland: Werty
Haraba: Dominica
Jarrod0303: Jarrod0303
Kyrutsk: Kokomo
Limeia: Spongy
Malinskrov: aTr
Nordleich: Frosty
Pacomia: Mopscrub
Republican Auvia: Notforc
Sudestavia: Portavia
Southvis: Yusuf
TBTGia: TBTG
United Carolina: Finn
Wisea: Wisest
Yazurek: Geo

